0,0,0,0,0,0,0,0,0,0
0,0,0,0,0,0,0,0,0,0
6,6,6,6,6,6,6,6,6,6
2,2,2,2,2,2,2,2,2,2
4,4,4,4,4,4,4,4,4,4
1,1,1,1,1,1,1,1,1,1
5,5,5,5,5,5,5,5,5,5
3,3,3,3,3,3,3,3,3,3
6,6,6,6,6,6,6,6,6,6
2,2,2,2,2,2,2,2,2,2
4,4,4,4,4,4,4,4,4,4
1,1,1,1,1,1,1,1,1,1
0,0,0,0,0,0,0,0,0,0
0,0,0,0,0,0,0,0,0,0
0,0,0,0,0,0,0,0,0,0
0,0,0,0,0,0,0,0,0,0
0,0,0,0,0,0,0,0,0,0
0,0,0,0,0,0,0,0,0,0
0,0,0,0,0,0,0,0,0,0
0,0,0,0,0,0,0,0,0,0

